36:64
0:0:0:0:0
11:15:0:4:0
10:15:0:4:0
10:16:0:4:0
10:17:0:4:0
9:17:0:4:0
9:18:0:4:0
9:19:0:4:0
9:20:0:4:0
9:21:0:4:0
9:22:0:4:0
9:23:0:4:0
9:24:0:4:0
10:24:0:4:0
10:25:0:4:0
11:26:0:4:0
11:27:0:4:0
12:27:0:4:0
12:28:0:4:0
13:29:0:4:0
13:30:0:4:0
13:31:0:4:0
14:31:0:4:0
14:32:0:4:0
14:33:0:4:0
14:34:0:4:0
14:35:0:4:0
15:36:0:4:0
15:37:0:4:0
15:38:0:4:0
15:39:0:4:0
15:40:0:4:0
15:41:0:4:0
15:42:0:4:0
16:42:0:4:0
11:25:0:4:0
12:29:0:4:0
15:35:0:4:0
13:63:0:4:0
12:15:0:2:0
17:42:0:3:0
13:19:0:0:3
13:20:0:0:3
13:21:0:0:3
14:22:0:0:3
15:22:0:0:3
16:22:0:0:3
16:23:0:0:3
17:23:0:0:3
17:24:0:0:3
18:25:0:0:3
18:26:0:0:3
18:27:0:0:3
17:28:0:0:3
18:28:0:0:3
19:28:0:0:3
19:27:0:0:3
19:26:0:0:3
19:25:0:0:3
19:24:0:0:3
19:23:0:0:3
19:22:0:0:3
18:22:0:0:3
18:21:0:0:3
18:20:0:0:3
17:20:0:0:3
16:20:0:0:3
15:19:0:0:3
14:19:0:0:3
14:20:0:0:3
15:20:0:0:3
14:21:0:0:3
15:21:0:0:3
16:21:0:0:3
17:21:0:0:3
18:23:0:0:3
17:22:0:0:3
18:24:0:0:3
19:29:0:0:3
19:30:0:0:3
18:30:0:0:3
18:29:0:0:3
18:31:0:0:3
18:32:0:0:3
19:32:0:0:3
19:33:0:0:3
20:32:0:0:3
20:31:0:0:3
19:31:0:0:3
20:30:0:0:3
20:29:0:0:3
20:28:0:0:3
20:27:0:0:3
20:26:0:0:3
20:25:0:0:3
20:24:0:0:3
20:23:0:0:3
20:22:0:0:3
20:21:0:0:3
20:20:0:0:3
19:20:0:0:3
19:21:0:0:3
34:35:0:0:3
24:37:0:0:6
25:23:0:0:6
20:14:0:0:6
7:36:0:0:6
2:26:0:0:6
2:14:0:0:6
11:3:0:0:6
14:12:0:0:6
13:19:3:1:0
13:20:3:1:0
13:21:3:1:0
14:22:3:1:0
15:22:3:1:0
16:23:3:1:0
17:24:3:1:0
18:24:3:0:0
18:25:3:1:0
18:26:3:1:0
18:27:3:1:0
17:28:3:1:0
18:29:3:1:0
18:30:3:1:0
18:31:3:1:0
18:32:3:1:0
19:33:3:1:0
20:32:3:1:0
20:31:3:1:0
20:30:3:1:0
20:29:3:1:0
20:28:3:1:0
20:27:3:1:0
20:26:3:1:0
20:25:3:1:0
20:24:3:1:0
20:23:3:1:0
20:22:3:1:0
20:21:3:1:0
20:20:3:1:0
19:20:3:1:0
18:20:3:1:0
17:20:3:1:0
16:20:3:1:0
15:19:3:1:0
14:19:3:1:0
34:33:3:1:0
29:32:0:0:5
24:10:0:0:5
15:10:0:0:5
5:9:0:0:5
34:30:0:0:5
22:30:0:0:4
17:27:1:0:5
10:28:1:0:5
6:20:1:0:5