36:64
0:0:0:0:0
8:14:0:4:0
8:15:0:4:0
8:16:0:4:0
8:17:0:4:0
8:18:0:4:0
8:19:0:4:0
8:20:0:4:0
8:21:0:4:0
8:22:0:4:0
8:23:0:4:0
8:24:0:4:0
8:25:0:4:0
8:26:0:4:0
8:27:0:4:0
8:28:0:4:0
8:29:0:4:0
9:29:0:4:0
9:30:0:4:0
9:31:0:4:0
8:31:0:4:0
8:32:0:4:0
8:33:0:4:0
8:34:0:4:0
8:35:0:4:0
8:36:0:4:0
8:37:0:4:0
8:38:0:4:0
8:39:0:4:0
8:40:0:4:0
8:41:0:4:0
8:42:0:4:0
8:43:0:4:0
8:45:0:4:0
8:46:0:4:0
8:47:0:4:0
8:48:0:4:0
8:49:0:4:0
10:51:0:4:0
10:52:0:4:0
11:52:0:4:0
11:53:0:4:0
12:53:0:4:0
12:54:0:4:0
13:54:0:4:0
14:54:0:4:0
15:54:0:4:0
16:54:0:4:0
16:53:0:4:0
16:52:0:4:0
16:51:0:4:0
16:50:0:4:0
16:49:0:4:0
16:48:0:4:0
16:47:0:4:0
16:46:0:4:0
16:45:0:4:0
16:44:0:4:0
16:43:0:4:0
16:42:0:4:0
16:41:0:4:0
16:40:0:4:0
16:39:0:4:0
16:38:0:4:0
16:37:0:4:0
16:36:0:4:0
16:35:0:4:0
16:34:0:4:0
15:33:0:4:0
15:32:0:4:0
15:31:0:4:0
15:30:0:4:0
14:30:0:4:0
14:29:0:4:0
14:28:0:4:0
14:27:0:4:0
13:27:0:4:0
13:26:0:4:0
13:25:0:4:0
15:34:0:4:0
13:24:0:4:0
13:23:0:4:0
13:22:0:4:0
13:21:0:4:0
13:20:0:4:0
13:19:0:4:0
12:19:0:4:0
12:18:0:4:0
12:17:0:4:0
12:16:0:4:0
12:15:0:4:0
12:14:0:4:0
12:13:0:4:0
12:12:0:4:0
12:11:0:4:0
12:10:0:4:0
12:9:0:4:0
13:9:0:4:0
14:9:0:4:0
14:8:0:4:0
15:8:0:4:0
16:8:0:4:0
17:8:0:4:0
18:7:0:4:0
19:7:0:4:0
19:8:0:4:0
19:9:0:4:0
19:10:0:4:0
19:11:0:4:0
19:12:0:4:0
19:13:0:4:0
19:14:0:4:0
19:15:0:4:0
17:7:0:4:0
19:16:0:4:0
19:17:0:4:0
19:18:0:4:0
19:19:0:4:0
19:20:0:4:0
19:21:0:4:0
19:22:0:4:0
20:22:0:4:0
20:23:0:4:0
20:24:0:4:0
20:25:0:4:0
20:26:0:4:0
20:27:0:4:0
20:28:0:4:0
20:29:0:4:0
20:30:0:4:0
20:31:0:4:0
20:32:0:4:0
20:33:0:4:0
21:33:0:4:0
21:34:0:4:0
21:35:0:4:0
21:36:0:4:0
21:37:0:4:0
21:38:0:4:0
21:39:0:4:0
21:40:0:4:0
21:41:0:4:0
21:42:0:4:0
21:43:0:4:0
21:44:0:4:0
21:45:0:4:0
21:46:0:4:0
21:47:0:4:0
21:48:0:4:0
21:49:0:4:0
21:50:0:4:0
21:51:0:4:0
21:52:0:4:0
21:53:0:4:0
21:54:0:4:0
21:55:0:4:0
22:55:0:4:0
22:56:0:4:0
22:57:0:4:0
23:57:0:4:0
24:58:0:4:0
25:58:0:4:0
26:58:0:4:0
26:57:0:4:0
26:56:0:4:0
26:55:0:4:0
27:54:0:4:0
27:53:0:4:0
27:52:0:4:0
27:51:0:4:0
27:50:0:4:0
27:49:0:4:0
27:48:0:4:0
27:47:0:4:0
27:46:0:4:0
26:46:0:4:0
26:45:0:4:0
26:44:0:4:0
26:43:0:4:0
26:42:0:4:0
26:41:0:4:0
26:40:0:4:0
26:39:0:4:0
26:38:0:4:0
26:37:0:4:0
26:36:0:4:0
26:35:0:4:0
26:34:0:4:0
26:33:0:4:0
26:32:0:4:0
26:31:0:4:0
26:30:0:4:0
26:29:0:4:0
26:28:0:4:0
26:27:0:4:0
26:26:0:4:0
26:25:0:4:0
26:24:0:4:0
26:23:0:4:0
26:22:0:4:0
26:21:0:4:0
26:20:0:4:0
27:20:0:4:0
27:19:0:4:0
27:18:0:4:0
27:17:0:4:0
27:16:0:4:0
27:15:0:4:0
27:14:0:4:0
28:14:0:4:0
28:13:0:4:0
28:12:0:4:0
28:11:0:4:0
28:10:0:4:0
28:9:0:4:0
28:8:0:4:0
28:7:0:4:0
28:6:0:4:0
27:55:0:4:0
23:58:0:4:0
8:13:0:2:0
28:5:0:3:0
16:12:0:0:3
17:12:0:0:3
17:13:0:0:3
17:14:0:0:3
17:15:0:0:3
16:16:0:0:3
16:17:0:0:3
16:18:0:0:3
16:19:0:0:3
17:20:0:0:3
17:21:0:0:3
17:22:0:0:3
17:23:0:0:3
16:23:0:0:3
16:22:0:0:3
16:21:0:0:3
15:21:0:0:3
15:20:0:0:3
16:13:0:0:3
16:14:0:0:3
16:15:0:0:3
17:19:0:0:3
17:17:0:0:3
17:16:0:0:3
17:18:0:0:3
16:20:0:0:3
15:19:0:0:3
15:18:0:0:3
15:17:0:0:3
15:16:0:0:3
15:15:0:0:3
15:14:0:0:3
15:13:0:0:3
14:13:0:0:3
14:12:0:0:3
14:14:0:0:3
14:15:0:0:3
14:16:0:0:3
15:12:0:0:3
15:11:0:0:3
16:11:0:0:3
14:12:3:1:0
14:13:3:1:0
14:15:3:1:0
14:16:3:1:0
14:14:3:1:0
15:11:3:1:0
16:11:3:1:0
17:12:3:1:0
17:14:3:1:0
17:13:3:1:0
17:15:3:1:0
17:16:3:1:0
17:17:3:1:0
17:18:3:1:0
17:19:3:1:0
17:20:3:1:0
17:22:3:1:0
17:21:3:1:0
17:23:3:1:0
16:23:3:1:0
16:22:3:1:0
15:21:3:1:0
15:20:3:1:0
15:19:3:1:0
15:18:3:1:0
15:17:3:1:0
34:35:3:0:0
9:39:0:0:6
1:21:0:0:6
9:3:0:0:6
21:10:0:0:6
28:41:0:0:6
5:56:0:0:6
1:43:0:0:6
20:18:0:0:6
34:33:0:0:5
27:23:0:0:5
29:14:0:0:5
3:7:0:0:5
9:33:0:0:5
10:47:0:0:5
35:30:0:0:5
34:30:0:0:5
32:62:0:0:4
20:48:1:0:4
14:31:1:0:4
19:24:1:0:4
25:34:1:0:4
1:14:1:0:4
7:18:1:0:4
12:24:1:0:4
35:63:1:0:6
35:62:3:0:0
32:62:3:1:0
17:62:3:0:0
32:62:1:0:5
35:35:2:0:5
19:48:2:0:6
19:40:2:0:6
18:35:2:0:6
23:31:0:0:3
23:30:0:0:3
23:29:0:0:3
22:30:0:0:3
22:31:0:0:3
32:63:0:0:3
32:63:1:0:3
35:32:2:0:3
26:35:2:0:5
19:62:2:0:5
17:52:3:1:0
18:52:3:1:0
19:52:3:1:0
20:52:3:1:0
1:29:0:0:6
8:44:0:4:0
8:50:0:4:0
8:51:0:4:0
7:53:0:4:0
6:53:0:4:0
6:54:0:4:0
5:54:0:4:0
4:54:0:4:0
3:51:0:4:0
4:51:0:4:0
5:51:0:4:0
8:52:0:4:0
6:51:0:4:0
7:51:0:4:0
9:51:0:4:0
8:53:0:4:0
4:55:0:4:0
4:56:0:4:0
4:57:0:4:0
4:58:0:4:0
4:59:0:4:0
3:59:0:4:0
2:59:0:4:0
2:58:0:4:0
1:58:0:4:0
1:57:0:4:0
1:56:0:4:0
1:55:0:4:0
1:54:0:4:0
1:53:0:4:0
1:52:0:4:0
2:51:0:4:0
2:52:0:4:0