36:64
0:0:0:0:0
14:11:0:4:0
13:11:0:4:0
13:12:0:4:0
12:12:0:4:0
12:13:0:4:0
11:14:0:4:0
11:15:0:4:0
11:16:0:4:0
10:16:0:4:0
10:17:0:4:0
10:18:0:4:0
10:19:0:4:0
9:20:0:4:0
9:21:0:4:0
9:22:0:4:0
9:23:0:4:0
9:24:0:4:0
8:24:0:4:0
8:25:0:4:0
8:26:0:4:0
8:27:0:4:0
8:28:0:4:0
8:29:0:4:0
8:30:0:4:0
8:31:0:4:0
8:32:0:4:0
9:32:0:4:0
9:33:0:4:0
9:34:0:4:0
9:35:0:4:0
10:35:0:4:0
10:36:0:4:0
10:37:0:4:0
11:37:0:4:0
12:37:0:4:0
13:36:0:4:0
13:35:0:4:0
14:34:0:4:0
14:33:0:4:0
14:32:0:4:0
14:31:0:4:0
15:30:0:4:0
15:29:0:4:0
15:28:0:4:0
15:27:0:4:0
15:26:0:4:0
15:25:0:4:0
16:25:0:4:0
16:24:0:4:0
16:23:0:4:0
17:23:0:4:0
17:22:0:4:0
18:22:0:4:0
18:21:0:4:0
19:21:0:4:0
19:20:0:4:0
20:20:0:4:0
21:20:0:4:0
22:20:0:4:0
23:20:0:4:0
24:21:0:4:0
24:22:0:4:0
25:22:0:4:0
25:23:0:4:0
25:24:0:4:0
25:25:0:4:0
25:26:0:4:0
26:26:0:4:0
26:27:0:4:0
26:28:0:4:0
26:29:0:4:0
26:30:0:4:0
26:31:0:4:0
26:32:0:4:0
26:33:0:4:0
26:34:0:4:0
26:35:0:4:0
26:36:0:4:0
26:37:0:4:0
26:38:0:4:0
26:39:0:4:0
26:40:0:4:0
26:41:0:4:0
26:42:0:4:0
26:43:0:4:0
26:44:0:4:0
25:45:0:4:0
25:46:0:4:0
24:47:0:4:0
24:48:0:4:0
24:49:0:4:0
23:49:0:4:0
23:50:0:4:0
22:50:0:4:0
22:51:0:4:0
21:51:0:4:0
20:52:0:4:0
19:52:0:4:0
19:53:0:4:0
18:53:0:4:0
17:53:0:4:0
16:53:0:4:0
15:53:0:4:0
14:53:0:4:0
13:53:0:4:0
13:52:0:4:0
5:46:0:4:0
5:45:0:4:0
4:45:0:4:0
4:44:0:4:0
21:52:0:4:0
25:47:0:4:0
26:45:0:4:0
23:21:0:4:0
15:31:0:4:0
14:35:0:4:0
13:37:0:4:0
10:20:0:4:0
12:14:0:4:0
15:11:0:2:0
4:43:0:3:0
21:29:0:0:3
21:30:0:0:3
20:30:0:0:3
20:31:0:0:3
20:32:0:0:3
20:33:0:0:3
20:34:0:0:3
20:35:0:0:3
20:36:0:0:3
20:37:0:0:3
20:38:0:0:3
20:39:0:0:3
20:40:0:0:3
20:41:0:0:3
21:41:0:0:3
21:42:0:0:3
21:43:0:0:3
22:43:0:0:3
22:42:0:0:3
23:42:0:0:3
23:41:0:0:3
23:40:0:0:3
23:39:0:0:3
23:38:0:0:3
23:37:0:0:3
23:36:0:0:3
23:35:0:0:3
22:35:0:0:3
22:34:0:0:3
22:33:0:0:3
22:32:0:0:3
22:31:0:0:3
22:30:0:0:3
22:29:0:0:3
22:28:0:0:3
22:27:0:0:3
23:31:0:0:3
23:32:0:0:3
23:33:0:0:3
23:34:0:0:3
24:35:0:0:3
24:36:0:0:3
24:37:0:0:3
21:28:0:0:3
21:27:0:0:3
21:26:0:0:3
20:26:0:0:3
19:26:0:0:3
19:27:0:0:3
19:28:0:0:3
19:29:0:0:3
19:30:0:0:3
19:31:0:0:3
19:32:0:0:3
19:33:0:0:3
19:34:0:0:3
19:35:0:0:3
19:36:0:0:3
19:37:0:0:3
19:38:0:0:3
19:40:0:0:3
19:39:0:0:3
18:35:0:0:3
18:36:0:0:3
18:37:0:0:3
18:38:0:0:3
18:39:0:0:3
18:40:0:0:3
18:41:0:0:3
19:41:0:0:3
19:42:0:0:3
20:42:0:0:3
20:43:0:0:3
21:44:0:0:3
22:44:0:0:3
23:43:0:0:3
24:38:0:0:3
22:36:0:0:3
21:32:0:0:3
21:31:0:0:3
20:29:0:0:3
20:28:0:0:3
20:27:0:0:3
18:27:0:0:3
18:28:0:0:3
18:32:0:0:3
18:33:0:0:3
18:34:0:0:3
17:36:0:0:3
17:37:0:0:3
17:38:0:0:3
17:39:0:0:3
21:33:0:0:3
21:34:0:0:3
21:35:0:0:3
21:36:0:0:3
21:39:0:0:3
21:40:0:0:3
22:39:0:0:3
22:38:0:0:3
21:38:0:0:3
22:37:0:0:3
21:37:0:0:3
22:40:0:0:3
22:41:0:0:3
6:3:0:0:4
18:5:0:0:4
1:36:0:0:4
12:46:0:0:4
11:39:0:0:4
24:12:0:0:4
15:17:0:0:4
16:17:0:0:4
22:49:0:0:4
23:58:0:0:4
13:56:0:0:4
28:19:0:0:5
30:8:0:0:5
19:11:0:0:5
7:9:0:0:5
12:15:0:0:5
1:19:0:0:5
1:29:0:0:5
6:41:0:0:5
3:55:0:4:0
12:42:0:0:6
22:16:0:0:6
13:4:0:0:6
2:12:0:0:6
1:23:0:0:6
34:35:0:4:0
27:36:0:0:6
25:28:1:0:6
22:24:1:0:6
13:28:1:0:6
9:21:1:0:6
7:28:1:0:5
10:18:1:0:4
25:34:1:0:4
17:46:1:0:4
17:36:3:1:0
17:37:3:1:0
17:39:3:1:0
17:38:3:1:0
18:40:3:1:0
18:41:3:1:0
18:42:3:1:0
19:42:3:1:0
20:43:3:1:0
21:44:3:1:0
22:44:3:1:0
23:43:3:1:0
23:42:3:1:0
23:41:3:1:0
23:40:3:1:0
23:39:3:1:0
24:38:3:1:0
17:62:3:1:0
12:52:0:4:0
11:52:0:4:0
10:52:0:4:0
9:52:0:4:0
8:52:0:4:0
7:52:0:4:0
7:53:0:4:0
6:53:0:4:0
6:54:0:4:0
5:54:0:4:0
5:55:0:4:0
4:55:0:4:0
2:55:0:4:0
2:54:0:4:0
2:53:0:4:0
2:52:0:4:0
2:51:0:4:0
2:50:0:4:0
2:49:0:4:0
2:48:0:4:0
3:48:0:4:0
4:48:0:4:0
5:48:0:4:0
5:47:0:4:0
25:42:1:0:6