36:64
0:0:0:0:0
14:16:3:1:0
14:17:3:0:0
14:18:3:0:0
14:19:3:0:0
14:20:3:0:0
14:21:3:0:0
17:33:3:1:0
17:34:3:0:0
17:35:3:1:0
17:36:3:0:0
14:22:3:0:0
12:15:0:0:3
13:15:0:0:3
13:16:0:0:3
14:16:0:0:3
15:17:0:0:3
16:18:0:0:3
16:19:0:0:3
16:20:0:0:3
16:21:0:0:3
16:22:0:0:3
16:23:0:0:3
15:23:0:0:3
15:24:0:0:3
14:24:0:0:3
14:23:0:0:3
14:22:0:0:3
14:21:0:0:3
14:20:0:0:3
14:19:0:0:3
14:18:0:0:3
14:17:0:0:3
15:18:0:0:3
15:19:0:0:3
16:24:0:0:3
15:22:0:0:3
15:21:0:0:3
15:20:0:0:3
13:17:0:0:3
13:18:0:0:3
13:19:0:0:3
13:20:0:0:3
13:21:0:0:3
13:23:0:0:3
12:22:0:0:3
13:22:0:0:3
16:34:0:0:3
17:34:0:0:3
18:34:0:0:3
14:24:3:1:0
15:24:3:1:0
16:24:3:1:0
16:23:3:1:0
16:22:3:1:0
16:21:3:1:0
8:12:0:4:0
8:13:0:4:0
8:14:0:4:0
8:15:0:4:0
8:16:0:4:0
8:17:0:4:0
8:18:0:4:0
8:19:0:4:0
8:20:0:4:0
8:21:0:4:0
8:22:0:4:0
9:23:0:4:0
9:24:0:4:0
9:25:0:4:0
9:26:0:4:0
9:27:0:4:0
10:27:0:4:0
11:27:0:4:0
12:27:0:4:0
12:28:0:4:0
13:28:0:4:0
14:28:0:4:0
15:28:0:4:0
16:28:0:4:0
17:28:0:4:0
17:27:0:4:0
18:27:0:4:0
19:27:0:4:0
19:26:0:4:0
20:26:0:4:0
20:25:0:4:0
21:25:0:4:0
21:24:0:4:0
21:23:0:4:0
21:22:0:4:0
21:21:0:4:0
21:20:0:4:0
21:19:0:4:0
8:23:0:4:0
8:11:0:2:0
21:18:0:3:0
16:20:3:1:0
16:19:3:1:0
16:18:3:1:0
15:17:3:1:0
13:23:3:1:0
12:22:3:1:0
13:21:3:1:0
13:20:3:1:0
13:18:3:1:0
13:17:3:1:0
13:16:3:1:0
13:19:3:1:0
13:15:3:1:0
12:15:3:1:0
14:35:0:0:3
13:35:0:0:3
12:35:0:0:3
11:35:0:0:3
11:34:0:0:3
12:33:0:0:3
13:33:0:0:3
13:32:0:0:3
14:32:0:0:3
14:33:0:0:3
14:34:0:0:3
12:34:0:0:3
11:33:0:0:3
12:32:0:0:3
11:32:0:0:3
13:34:0:0:3
10:32:0:0:3
10:33:0:0:3
10:34:0:0:3
10:35:0:0:3
11:36:0:0:3
12:36:0:0:3
13:36:0:0:3
14:36:0:0:3
10:36:0:0:3
10:32:3:1:0
10:33:3:1:0
10:34:3:1:0
10:35:3:1:0
10:36:3:1:0
11:36:3:1:0
12:36:3:1:0
13:36:3:1:0
14:36:3:1:0
14:35:3:1:0
14:34:3:1:0
14:33:3:1:0
14:32:3:1:0
13:32:3:1:0
12:32:3:1:0
11:32:3:1:0
20:29:0:0:3
21:29:0:0:3
22:29:0:0:3
22:30:0:0:3
23:30:0:0:3
23:31:0:0:3
24:31:0:0:3
24:32:0:0:3
24:33:0:0:3
23:34:0:0:3
23:35:0:0:3
22:35:0:0:3
21:35:0:0:3
20:34:0:0:3
20:33:0:0:3
34:31:0:0:3
20:10:0:0:4
25:15:0:0:4
15:12:0:0:4
10:9:0:0:4
7:4:0:0:4
33:63:0:0:5
6:18:1:0:5
4:27:1:0:5
1:22:1:0:5
16:31:1:0:5
26:35:1:0:5
28:23:1:0:5
26:4:1:0:5
17:3:1:0:5
34:35:1:0:5
23:24:1:0:6
25:18:1:0:6
22:14:1:0:6
27:9:1:0:6
18:7:1:0:6
14:5:1:0:6
35:31:1:0:6
30:28:1:0:4
25:30:1:0:4
18:21:1:0:4
15:18:1:0:4